100000000000000000000000000000000000000000000000000000002
1                                                       2
1                                                       2
1                                                       2
1                                                       2
1                                                       2
1                                                       2
1                                                       2
1                                                       2                                                       2
1                                                       2
1                                                       2
1                                                       2                                                       2
1                                                       2
1                                                       2
1                                                       2                                                       2
1                                                       2
000000000000000000000000000000000000000000000000000000000





