map2.txt
wwwwwwwwwwwwwwwwwwwwwwww
w                      w
w                      w
wwwwwwwwwwwwwwwwww     w
                 w     w                w
                 w     w                w
                 w     w                w
                 w     w                w
                 w     w                w
                 w     w                w
                 w     wwwwwwwwwwwwww   wwwwwwwwwwwwwwwwwwwwwwwwwwwwwwwwww
                 w                                                       w
                 w                                                       w
                 w                                         wwwwwww       w
                 w                                         w     w       w
                 wwwwwwwwwwwwwwwwwwwwwwwwwwwwwwwwwwwwwwwwwww     wwwwwwwww