map2.txt
wwwwwwwwwwwwwwwwwwwwwwww
w                      w
w                      w
wwwwwwwwwwwwwwwwww     w
                 w     w                w
                 w     w                w
                 w     w                w
                 w     w                w
                 w     w                w
                 w     w                w
                 w     wwwwwwwwwwwwww   wwwwwwwwwwwwwwwwwwwwwwwwwwwwwww
                 w
                 w
                 w                                         wwwwwww
                 w                                         w     w
                 wwwwwwwwwwwwwwwwwwwwwwwwwwwwwwwwwwwwwwwwwww     wwwwww