22222222222222222222222
21111111111111111111612
21111111111110000000002
21111151110000000000002
21111111100000000000002
21111111100000000000002
21111111000000000000002
21111111000000000000002
21111111000000000000002
21511111000000000000002
21111111000000000000002
21111111000000000000002
21111111100000000000002
21111111100000000000002
21111111110000000000002
21111511111110000000002
21511111111111111111112
22222222222222222222222