1111111111111111111111114111111111111111111111111111
1111111111111111111111114111111111111111111111111111
1111111111111111111111114111111111111111111111111111
1111111111111111110000004000000000111111111111111111
1111111111111111000000004000000000001111111111111111
1111111111111000000000004000000000000001111111111111
1111111111110000000000004000000000000000111111111111
1111111111110000000000004000000000000000111111111111
1111111111100000000000004000000000000000011111111111
1111111111100000000000004000000000000000011111111111
1111111111100000000000004000000000000000011111111111
1111111111100000000000004000000000000000011111111111
1111111111100000000000004000000000000000011111111111
1111111111100000000000004000000000000000011111111111
1111111111110000000000004000000000000000111111111111
1111111111110000000000004000000000000000111111111111
1111111111111000000000004000000000000001111111111111
1111111111111111000000004000000000001111111111111111
1111111111111111110000004000000000111111111111111111
1111111111111111111111114111111111111111111111111111
1111111111111111111111114111111111111111111111111111
1111111111111111111111114111111111111111111111111111