000000000000000000000000000000000000000000000000000000000000000000000000000000
000000000000000000000000000000000000000000000000000000000000000000000000000000
000000000000000000000000000000000000000000000000000222222200000000000000000000
000000000022222222222200000000000000000000000002222223333222000000000000000000
000000222211122222222220000000000000000000000000002222333322220000000000000000
000022211111112211222000000000000000000000000000000022222220000000000000000000
222211111111111111112200000000000000000000000000000000000000000000000000000000
211111111111111111111200000000000000000000000000000000000000000000000000000000
211111111111111111111222000000000000000000000000000000000000000000000000000000
211111111111111111111112222222000000222222222200000000000000000000000000000000
211111111111111111111222211111111112222222222220000000000000000000000000000000
211111111333111111111111222222222222221111122222222000000000000000000000000000
211111111111111111111111111111111111111111111111112222200000000000000000000000
211111111111111111111111111111111111111111111111111122220000000000000000000000
211111111111111111111111111111111111111111111111111111120000000000000000000000
211111111111111113333333333311111111111111111111111111222000000000000000000000
211111111111111133333333333311111111111111111111111111112000000000000000000000
211111111111111111133331111333111111111111111111111111120000000000000000000000
211111111111111111111111111111111111111111111111111111120000000000000000000000
221111111111111111111111111111111111111111111111111111120000000000000000000000
222222222222222222222222222222222222222222222222222222200000000000000000000000
